Unnamed: 0_level_0_Player,Unnamed: 1_level_0_Nation,Unnamed: 2_level_0_Pos,Unnamed: 3_level_0_Age,Unnamed: 4_level_0_90s,Tackles_Tkl,Tackles_TklW,Tackles_Def 3rd,Tackles_Mid 3rd,Tackles_Att 3rd,Challenges_Tkl,Challenges_Att,Challenges_Tkl%,Challenges_Lost,Blocks_Blocks,Blocks_Sh,Blocks_Pass,Unnamed: 17_level_0_Int,Unnamed: 18_level_0_Tkl+Int,Unnamed: 19_level_0_Clr,Unnamed: 20_level_0_Err,Unnamed: 21_level_0_Matches,Team
Claudia Dickey,us USA,GK,25-233,17.0,0,0,0,0,0,0,1,0.0,1,0,0,0,0,0,8,0,Matches,Seattle Reign FC
Phoebe McClernon,us USA,DF,27-257,15.9,24,21,14,9,1,18,22,81.8,4,18,12,6,20,44,102,1,Matches,Seattle Reign FC
Madeline Dahlien,us USA,"DF,FW",21-033,14.6,29,21,8,15,6,16,30,53.3,14,13,1,12,7,36,15,0,Matches,Seattle Reign FC
Jordyn Bugg,us USA,DF,19-016,14.9,27,15,17,7,3,11,17,64.7,6,14,5,9,21,48,93,2,Matches,Seattle Reign FC
Madison Curry,us USA,DF,24-216,14.6,44,27,23,16,5,18,33,54.5,15,24,6,18,32,76,60,0,Matches,Seattle Reign FC
Samantha Meza,us USA,MF,23-293,12.8,63,40,28,33,2,25,47,53.2,22,32,8,24,23,86,23,0,Matches,Seattle Reign FC
Jordyn Huitema,ca CAN,"FW,MF",24-111,10.1,6,3,1,4,1,3,9,33.3,6,8,5,3,10,16,17,0,Matches,Seattle Reign FC
Angharad James,wls WAL,MF,31-087,9.4,30,22,11,18,1,17,31,54.8,14,14,4,10,6,36,10,0,Matches,Seattle Reign FC
Lauren Barnes,us USA,DF,36-088,9.2,12,6,8,2,2,8,19,42.1,11,7,1,6,8,20,35,0,Matches,Seattle Reign FC
Ji So-yun,kr KOR,"MF,FW",34-187,8.3,14,6,6,5,3,6,7,85.7,1,10,2,8,4,18,5,0,Matches,Seattle Reign FC
Shae Holmes,us USA,DF,25-172,9.3,12,6,7,4,1,4,8,50.0,4,10,3,7,10,22,53,0,Matches,Seattle Reign FC
Lynn Biyendolo,us USA,"FW,MF",32-098,8.8,10,6,0,3,7,2,6,33.3,4,9,2,7,1,11,9,0,Matches,Seattle Reign FC
Emeri Adames,us USA,"MF,FW",19-146,7.5,5,3,1,3,1,0,8,0.0,8,5,0,5,0,5,5,0,Matches,Seattle Reign FC
Sally Menti,us USA,MF,23-170,5.9,14,10,4,10,0,8,13,61.5,5,6,1,5,5,19,13,2,Matches,Seattle Reign FC
Nérilia Mondésir,ht HAI,"FW,MF",26-222,5.4,6,4,2,4,0,1,4,25.0,3,4,0,4,3,9,2,0,Matches,Seattle Reign FC
Ana-Maria Crnogorčević,ch SUI,"FW,MF",34-328,4.1,5,4,0,4,1,2,4,50.0,2,3,0,3,2,7,5,0,Matches,Seattle Reign FC
Jess Fishlock,wls WAL,"MF,FW",38-225,4.6,8,3,2,3,3,0,4,0.0,4,3,0,3,2,10,5,0,Matches,Seattle Reign FC
Sofia Huerta,us USA,DF,32-256,4.0,5,3,5,0,0,4,7,57.1,3,3,3,0,3,8,15,1,Matches,Seattle Reign FC
Maddie Mercado,us USA,"FW,MF",24-148,3.9,4,2,3,1,0,1,6,16.7,5,3,0,3,5,9,7,0,Matches,Seattle Reign FC
Ainsley Mccammon,us USA,MF,18-011,3.1,12,4,4,5,3,7,9,77.8,2,7,2,5,5,17,6,0,Matches,Seattle Reign FC
Emily Mason,us USA,DF,22-308,2.8,7,2,5,1,1,5,7,71.4,2,5,4,1,9,16,18,0,Matches,Seattle Reign FC
Mia Fishel,us USA,"MF,DF",24-119,0.7,1,1,0,0,1,0,0,,0,0,0,0,0,1,0,0,Matches,Seattle Reign FC
Olivia Van der Jagt,us USA,MF,26-037,0.2,0,0,0,0,0,0,0,,0,0,0,0,0,0,2,0,Matches,Seattle Reign FC
Hanna Glas,se SWE,FW,32-133,0.0,0,0,0,0,0,0,0,,0,0,0,0,0,0,0,0,Matches,Seattle Reign FC
Squad Total,,,26.3,17.0,338,209,149,147,42,156,292,53.4,136,198,59,139,176,514,508,6,,Seattle Reign FC
Opponent Total,,,27.1,17.0,296,186,124,123,49,138,223,61.9,85,179,39,140,144,440,392,6,,Seattle Reign FC
Sam Coffey,us USA,MF,26-239,15.7,40,27,11,18,11,15,28,53.6,13,23,5,18,18,58,34,0,Matches,Portland Thorns
Reyna Reyes,mx MEX,DF,24-192,15.5,30,22,14,12,4,16,24,66.7,8,21,5,16,22,52,45,0,Matches,Portland Thorns
Hina Sugita,jp JPN,MF,28-208,14.8,38,27,17,17,4,14,22,63.6,8,26,2,24,33,71,30,1,Matches,Portland Thorns
Olivia Moultrie,us USA,"MF,FW",19-344,15.0,30,16,8,14,8,17,35,48.6,18,18,2,16,10,40,12,0,Matches,Portland Thorns
Samantha Hiatt,us USA,DF,27-233,14.0,10,7,7,1,2,5,7,71.4,2,24,17,7,6,16,72,0,Matches,Portland Thorns
Reilyn Turner,us USA,"FW,MF",22-314,12.0,5,5,1,3,1,2,4,50.0,2,7,0,7,4,9,19,0,Matches,Portland Thorns
Isabella Obaze,dk DEN,DF,22-301,12.2,24,13,16,7,1,12,14,85.7,2,12,12,0,10,34,70,2,Matches,Portland Thorns
Jessie Fleming,ca CAN,MF,27-169,10.7,27,15,11,10,6,8,17,47.1,9,18,1,17,8,35,5,1,Matches,Portland Thorns
Kaitlyn Torpey,au AUS,DF,25-163,9.8,17,11,3,11,3,9,16,56.3,7,9,1,8,7,24,33,0,Matches,Portland Thorns
Mackenzie Arnold,au AUS,GK,31-183,10.0,0,0,0,0,0,0,0,,0,0,0,0,0,0,7,1,Matches,Portland Thorns
Jayden Perry,us USA,DF,24-188,9.1,12,4,6,3,3,4,10,40.0,6,9,4,5,7,19,40,0,Matches,Portland Thorns
Deyna Castellanos,ve VEN,"FW,MF",26-131,9.0,6,6,1,4,1,1,7,14.3,6,6,0,6,6,12,7,0,Matches,Portland Thorns
Caiya Hanks,us USA,"FW,MF",20-335,7.1,16,11,8,4,4,9,14,64.3,5,12,0,12,6,22,5,0,Matches,Portland Thorns
Bella Bixby,us USA,GK,29-280,7.0,0,0,0,0,0,0,0,,0,0,0,0,0,0,5,0,Matches,Portland Thorns
Mallie McKenzie,us USA,DF,24-287,6.3,10,5,8,0,2,5,7,71.4,2,6,4,2,5,15,17,0,Matches,Portland Thorns
Marie-Yasmine Alidou,ca CAN,"MF,FW",30-121,5.4,10,5,2,6,2,8,9,88.9,1,3,0,3,1,11,6,0,Matches,Portland Thorns
Pietra Tordin,us USA,FW,21-150,5.5,4,4,0,2,2,0,6,0.0,6,5,0,5,0,4,1,0,Matches,Portland Thorns
Payton Linnehan,us USA,"FW,MF",24-155,4.8,9,6,2,7,0,2,9,22.2,7,5,0,5,1,10,5,0,Matches,Portland Thorns
Alexa Spaanstra,us USA,"FW,DF",25-207,2.2,3,1,3,0,0,2,4,50.0,2,5,0,5,1,4,0,0,Matches,Portland Thorns
Sophie Hirst,us USA,"MF,FW",25-183,0.4,0,0,0,0,0,0,1,0.0,1,1,0,1,0,0,2,0,Matches,Portland Thorns
Daiane,br BRA,DF,27-354,0.2,1,0,1,0,0,1,1,100.0,0,1,0,1,2,3,2,0,Matches,Portland Thorns
Julie Dufour,fr FRA,FW,24-090,0.1,0,0,0,0,0,0,0,,0,0,0,0,0,0,0,0,Matches,Portland Thorns
Squad Total,,,25.5,17.0,292,185,119,119,54,130,235,55.3,105,211,53,158,147,439,417,5,,Portland Thorns
Opponent Total,,,26.9,17.0,335,219,141,143,51,155,268,57.8,113,210,69,141,157,492,423,10,,Portland Thorns
Gabrielle Carle,ca CAN,"DF,MF",26-319,16.3,38,29,15,17,6,20,28,71.4,8,20,6,14,15,53,59,1,Matches,Washington Spirit
Tara McKeown,us USA,DF,26-056,16.5,23,20,16,5,2,16,19,84.2,3,27,16,11,33,56,104,1,Matches,Washington Spirit
Aubrey Kingsbury,us USA,GK,33-280,16.0,0,0,0,0,0,0,0,,0,0,0,0,0,0,13,3,Matches,Washington Spirit
Rebeca Bernal,mx MEX,"DF,MF",27-361,16.0,25,17,12,10,3,17,28,60.7,11,13,6,7,31,56,83,3,Matches,Washington Spirit
Esme Morgan,eng ENG,DF,24-313,14.4,24,15,16,8,0,13,23,56.5,10,18,12,6,9,33,76,1,Matches,Washington Spirit
Narumi Miura,jp JPN,MF,28-055,13.8,32,18,8,20,4,11,19,57.9,8,17,6,11,17,49,23,0,Matches,Washington Spirit
Gift Monday,ng NGA,"FW,MF",23-261,10.9,17,13,5,6,6,4,7,57.1,3,15,1,14,3,20,8,0,Matches,Washington Spirit
Makenna Morris,us USA,"FW,DF",23-123,9.6,11,5,5,4,2,4,10,40.0,6,7,0,7,5,16,15,0,Matches,Washington Spirit
Ashley Hatch,us USA,"FW,MF",30-094,9.1,5,5,0,1,4,2,3,66.7,1,14,3,11,3,8,13,0,Matches,Washington Spirit
Croix Bethune,us USA,"MF,FW",24-166,8.7,15,11,3,6,6,4,11,36.4,7,3,0,3,5,20,6,1,Matches,Washington Spirit
Hal Hershfelt,us USA,MF,22-328,8.2,12,6,6,5,1,4,9,44.4,5,9,0,9,12,24,30,2,Matches,Washington Spirit
Rosemonde Kouassi,ci CIV,"FW,MF",23-244,8.3,12,7,5,6,1,3,9,33.3,6,4,0,4,7,19,4,1,Matches,Washington Spirit
Casey Krueger,us USA,"DF,MF",35-004,6.7,7,5,3,2,2,4,6,66.7,2,4,1,3,7,14,26,0,Matches,Washington Spirit
Leicy Santos,co COL,"MF,FW",29-103,6.9,18,13,12,5,1,8,18,44.4,10,10,2,8,10,28,5,0,Matches,Washington Spirit
Brittany Ratcliffe,us USA,"FW,MF",31-201,4.2,3,3,1,1,1,1,5,20.0,4,6,2,4,3,6,4,0,Matches,Washington Spirit
Courtney Brown,us USA,"MF,FW",24-275,4.1,11,8,4,4,3,3,6,50.0,3,11,0,11,2,13,8,0,Matches,Washington Spirit
Heather Stainbrook,us USA,MF,24-166,3.2,12,6,7,5,0,6,7,85.7,1,4,4,0,1,13,11,0,Matches,Washington Spirit
Kate Wiesner,us USA,DF,24-197,2.6,3,2,2,1,0,3,4,75.0,1,4,2,2,3,6,5,0,Matches,Washington Spirit
Trinity Rodman,us USA,"FW,MF",23-099,3.7,8,5,2,3,3,4,5,80.0,1,2,0,2,1,9,4,0,Matches,Washington Spirit
Sofia Cantore,it ITA,FW,25-331,1.8,2,0,0,0,2,0,0,,0,0,0,0,0,2,1,0,Matches,Washington Spirit
Chloe Ricketts,us USA,"MF,FW",18-096,1.8,6,3,3,1,2,2,3,66.7,1,2,0,2,2,8,3,0,Matches,Washington Spirit
Meg Boade,,MF,,1.2,3,3,1,2,0,1,2,50.0,1,2,0,2,2,5,1,0,Matches,Washington Spirit
Sandy MacIver,sct SCO,GK,27-070,1.0,0,0,0,0,0,0,0,,0,0,0,0,0,0,2,1,Matches,Washington Spirit
Kysha Sylla,fr FRA,"DF,MF",21-204,1.6,4,3,2,1,1,2,3,66.7,1,2,2,0,1,5,6,0,Matches,Washington Spirit
Paige Metayer,us USA,DF,24-338,0.3,2,0,2,0,0,1,1,100.0,0,2,0,2,1,3,1,0,Matches,Washington Spirit
Kiley Dulaney,,DF,,0.1,0,0,0,0,0,0,0,,0,1,1,0,0,0,1,0,Matches,Washington Spirit
Margie Detrizio,,MF,,0.1,1,1,0,1,0,1,1,100.0,0,0,0,0,0,1,1,0,Matches,Washington Spirit
Squad Total,,,27.0,17.0,294,198,130,114,50,134,227,59.0,93,197,64,133,173,467,513,14,,Washington Spirit
Opponent Total,,,27.2,17.0,337,201,157,130,50,157,297,52.9,140,216,50,166,195,532,399,8,,Washington Spirit
Kayla Sharples,us USA,DF,28-071,17.0,19,14,12,5,2,11,15,73.3,4,17,12,5,8,27,77,0,Matches,KC Current
Lorena,br BRA,GK,28-113,16.0,0,0,0,0,0,0,0,,0,0,0,0,0,0,8,0,Matches,KC Current
Temwa Chaŵinga,mw MWI,"FW,MF",26-341,15.4,33,22,13,12,8,5,12,41.7,7,9,1,8,7,40,14,0,Matches,KC Current
Claire Hutton,us USA,MF,19-228,13.1,39,29,16,18,5,16,28,57.1,12,21,6,15,22,61,24,0,Matches,KC Current
Isabel Rodriguez,us USA,DF,26-136,14.6,25,16,10,13,2,7,15,46.7,8,13,3,10,21,46,47,1,Matches,KC Current
Lo'eau LaBonta,us USA,MF,32-162,13.5,33,25,11,16,6,13,23,56.5,10,14,4,10,20,53,15,1,Matches,KC Current
Beatriz,br BRA,FW,31-253,11.8,21,11,5,9,7,4,12,33.3,8,19,4,15,3,24,9,0,Matches,KC Current
Ellie Wheeler,us USA,"DF,MF",23-256,10.9,9,7,7,2,0,7,12,58.3,5,7,3,4,14,23,31,0,Matches,KC Current
Vanessa DiBernardo,us USA,"MF,FW",33-104,9.8,19,13,4,10,5,7,13,53.8,6,11,0,11,10,29,10,0,Matches,KC Current
Hailie Mace,us USA,DF,28-156,11.3,18,11,8,8,2,6,15,40.0,9,11,3,8,30,48,37,0,Matches,KC Current
Debinha,br BRA,"FW,MF",33-311,10.1,13,8,3,6,4,6,14,42.9,8,13,0,13,5,18,3,0,Matches,KC Current
Michelle Cooper,us USA,"FW,MF",22-266,7.8,17,13,3,8,6,9,16,56.3,7,11,1,10,3,20,6,0,Matches,KC Current
Elizabeth Ball,us USA,DF,29-311,9.0,7,4,3,4,0,3,6,50.0,3,4,1,3,4,11,44,0,Matches,KC Current
Alana Cook,us USA,DF,28-138,6.5,11,6,6,5,0,2,2,100.0,0,2,2,0,4,15,30,0,Matches,KC Current
Raquel Rodríguez,cr CRC,MF,31-303,6.3,18,9,7,10,1,8,13,61.5,5,12,4,8,11,29,22,0,Matches,KC Current
Nichelle Prince,ca CAN,"FW,MF",30-189,5.2,17,13,8,7,2,4,6,66.7,2,8,1,7,9,26,8,0,Matches,KC Current
Haley Hopkins,us USA,"FW,MF",26-249,3.2,6,5,2,4,0,4,12,33.3,8,6,2,4,6,12,10,0,Matches,KC Current
Lacho Marta,ao ANG,"FW,DF",26-164,1.7,2,1,0,1,1,0,0,,0,3,0,3,1,3,3,0,Matches,KC Current
Laurel Ivory,us USA,GK,25-364,1.0,0,0,0,0,0,0,0,,0,0,0,0,0,0,1,0,Matches,KC Current
Ally Sentnor,us USA,MF,21-190,1.0,3,3,0,2,1,3,4,75.0,1,2,0,2,0,3,0,0,Matches,KC Current
Mary Long,us USA,FW,18-215,1.0,1,0,0,1,0,1,2,50.0,1,2,0,2,0,1,0,0,Matches,KC Current
Bayley Feist,us USA,"MF,FW",28-166,0.9,3,1,2,0,1,1,3,33.3,2,4,0,4,1,4,1,0,Matches,KC Current
Mwanalima Jereko,ke KEN,MF,27-357,0.0,0,0,0,0,0,0,0,,0,0,0,0,0,0,0,0,Matches,KC Current
Gabrielle Robinson,us USA,FW,24-070,0.0,0,0,0,0,0,0,0,,0,0,0,0,0,0,0,0,Matches,KC Current
Squad Total,,,28.1,17.0,314,211,120,141,53,117,223,52.5,106,189,47,142,179,493,400,2,,KC Current
Opponent Total,,,27.4,17.0,270,158,134,102,34,129,248,52.0,119,190,62,128,168,438,428,10,,KC Current
Kailen Sheridan,ca CAN,GK,30-042,17.0,1,1,1,0,0,1,1,100.0,0,0,0,0,0,1,2,3,Matches,San Diego Wave
Kenza Dali,fr FRA,MF,34-027,16.9,17,6,7,6,4,12,22,54.5,10,12,3,9,14,31,13,0,Matches,San Diego Wave
Perle Morroni,fr FRA,DF,27-316,16.9,44,28,29,12,3,24,34,70.6,10,19,1,18,21,65,18,0,Matches,San Diego Wave
Savannah McCaskill,us USA,MF,29-027,16.7,15,10,4,9,2,6,19,31.6,13,9,4,5,16,31,18,0,Matches,San Diego Wave
Delphine Cascarino,fr FRA,FW,28-203,16.3,45,30,15,22,8,11,24,45.8,13,15,0,15,11,56,2,1,Matches,San Diego Wave
Hanna Lundkvist,se SWE,DF,23-041,14.8,29,18,13,8,8,13,25,52.0,12,21,2,19,15,44,27,0,Matches,San Diego Wave
Gia Corley,de GER,"MF,FW",23-099,11.2,12,8,6,4,2,4,12,33.3,8,12,1,11,7,19,3,0,Matches,San Diego Wave
Kristen McNabb,us USA,DF,31-132,13.5,9,6,4,4,1,3,8,37.5,5,12,7,5,9,18,62,0,Matches,San Diego Wave
Trinity Armstrong,us USA,DF,18-033,12.2,13,9,11,2,0,6,11,54.5,5,14,10,4,12,25,47,1,Matches,San Diego Wave
Adriana Leon,ca CAN,FW,32-329,10.4,6,5,0,2,4,4,7,57.1,3,7,0,7,3,9,1,0,Matches,San Diego Wave
Kimmi Ascanio,us USA,"FW,MF",17-218,10.7,17,13,2,11,4,6,14,42.9,8,15,1,14,12,29,4,0,Matches,San Diego Wave
Kennedy Wesley,us USA,DF,24-172,10.4,6,6,5,1,0,3,5,60.0,2,5,3,2,4,10,47,1,Matches,San Diego Wave
Maria Sanchez,mx MEX,"FW,MF",29-188,6.3,9,6,3,5,1,1,3,33.3,2,10,0,10,2,11,4,0,Matches,San Diego Wave
Melanie Barcenas,us USA,FW,17-301,5.0,17,10,6,9,2,7,14,50.0,7,17,0,17,2,19,2,0,Matches,San Diego Wave
Kyra Carusa,ie IRL,FW,29-286,2.7,6,6,1,3,2,0,2,0.0,2,1,0,1,1,7,0,0,Matches,San Diego Wave
Chiamaka Okwuchukwu,ng NGA,FW,20-020,1.6,1,1,0,1,0,1,1,100.0,0,0,0,0,0,1,0,0,Matches,San Diego Wave
Favour Emmanuel,ng NGA,MF,22-354,0.8,3,3,1,2,0,0,2,0.0,2,0,0,0,2,5,1,0,Matches,San Diego Wave
Makenzy Doniak,us USA,"FW,MF",31-183,1.9,2,1,0,1,1,0,0,,0,3,1,2,0,2,4,0,Matches,San Diego Wave
Laurina Fazer,fr FRA,MF,21-318,0.4,1,0,1,0,0,1,2,50.0,1,2,0,2,0,1,3,0,Matches,San Diego Wave
Jordan Fusco,us USA,MF,21-350,0.3,2,1,1,1,0,1,2,50.0,1,0,0,0,1,3,1,0,Matches,San Diego Wave
Dudinha,br BRA,"MF,FW",20-054,0.2,0,0,0,0,0,0,0,,0,0,0,0,0,0,0,0,Matches,San Diego Wave
Quincy McMahon,us USA,DF,21-335,0.1,1,1,1,0,0,0,0,,0,1,0,1,0,1,0,0,Matches,San Diego Wave
Squad Total,,,27.0,17.0,256,169,111,103,42,104,208,50.0,104,175,33,142,132,388,259,6,,San Diego Wave
Opponent Total,,,26.8,17.0,381,246,167,140,74,165,311,53.1,146,228,56,172,161,542,513,13,,San Diego Wave
Anna Moorhouse,eng ENG,GK,30-150,16.6,0,0,0,0,0,0,1,0.0,1,0,0,0,0,0,10,3,Matches,Orlando Pride
Emily Sams,us USA,DF,26-057,16.3,29,20,18,9,2,18,26,69.2,8,16,12,4,18,47,60,1,Matches,Orlando Pride
Kylie Strom,us USA,DF,33-162,15.8,17,11,12,5,0,11,20,55.0,9,19,11,8,26,43,71,2,Matches,Orlando Pride
Haley Hanson,us USA,MF,29-206,15.7,38,27,18,12,8,15,27,55.6,12,15,5,10,14,52,32,0,Matches,Orlando Pride
Barbra Banda,zm ZAM,FW,25-160,14.4,14,9,1,5,8,3,12,25.0,9,12,2,10,2,16,1,0,Matches,Orlando Pride
Marta,br BRA,"FW,MF",39-189,12.3,16,12,5,6,5,6,9,66.7,3,5,0,5,15,31,2,0,Matches,Orlando Pride
Angelina,br BRA,MF,25-213,12.1,12,4,1,9,2,5,15,33.3,10,24,6,18,5,17,5,0,Matches,Orlando Pride
Ally Watt,us USA,"MF,FW",28-168,11.1,29,25,8,12,9,17,31,54.8,14,16,4,12,6,35,10,1,Matches,Orlando Pride
Kerry Abello,us USA,DF,25-344,10.8,31,21,22,5,4,20,27,74.1,7,9,1,8,4,35,26,1,Matches,Orlando Pride
Carson Pickett,us USA,"DF,MF",31-346,9.5,9,5,3,2,4,4,9,44.4,5,8,2,6,5,14,30,0,Matches,Orlando Pride
Morgan Gautrat,us USA,"MF,FW",32-182,7.4,13,10,8,3,2,6,8,75.0,2,16,2,14,6,19,5,0,Matches,Orlando Pride
Cori Dyke,us USA,DF,24-341,9.9,14,9,9,4,1,8,11,72.7,3,4,3,1,3,17,22,0,Matches,Orlando Pride
Oihane Hernández,es ESP,DF,25-115,6.2,8,4,5,1,2,3,4,75.0,1,10,2,8,12,20,19,0,Matches,Orlando Pride
Ally Lemos,us USA,"MF,FW",21-176,8.2,15,5,9,6,0,6,9,66.7,3,11,3,8,11,26,9,0,Matches,Orlando Pride
Summer Yates,us USA,MF,25-071,5.0,8,4,4,4,0,4,7,57.1,3,2,0,2,1,9,4,0,Matches,Orlando Pride
Prisca Chilufya,zm ZAM,"FW,MF",26-080,5.0,8,7,4,2,2,2,6,33.3,4,4,2,2,0,8,1,0,Matches,Orlando Pride
Julie Doyle,us USA,"MF,FW",26-362,2.6,5,1,1,2,2,3,5,60.0,2,3,0,3,1,6,0,0,Matches,Orlando Pride
Rafaelle,br BRA,DF,34-070,2.3,4,2,3,1,0,1,2,50.0,1,1,1,0,2,6,16,0,Matches,Orlando Pride
Zara Chavosi,ca CAN,DF,22-264,2.0,6,3,5,1,0,2,3,66.7,1,4,4,0,2,8,6,0,Matches,Orlando Pride
Simone Jackson,us USA,"MF,FW",22-211,1.8,2,1,1,1,0,1,6,16.7,5,3,0,3,2,4,1,0,Matches,Orlando Pride
Viviana Villacorta,us USA,"MF,DF",26-206,0.9,4,2,3,0,1,2,2,100.0,0,1,0,1,1,5,1,0,Matches,Orlando Pride
McKinley Crone,,GK,,0.4,0,0,0,0,0,0,0,,0,0,0,0,0,0,0,0,Matches,Orlando Pride
Grace Chanda,zm ZAM,MF,28-077,0.4,1,1,1,0,0,0,0,,0,0,0,0,1,2,0,0,Matches,Orlando Pride
Simone Charley,us USA,FW,30-204,0.4,0,0,0,0,0,0,0,,0,0,0,0,1,1,0,0,Matches,Orlando Pride
Brianna Martinez,us USA,FW,25-127,0.0,1,0,0,1,0,1,1,100.0,0,0,0,0,0,1,0,0,Matches,Orlando Pride
Squad Total,,,28.6,17.0,284,183,141,91,52,138,241,57.3,103,183,60,123,138,422,331,8,,Orlando Pride
Opponent Total,,,26.9,17.0,325,219,159,111,55,138,249,55.4,111,219,59,160,159,484,497,10,,Orlando Pride
Arin Wright,us USA,DF,32-245,17.0,18,12,9,6,3,13,19,68.4,6,28,14,14,18,36,105,3,Matches,Racing Louisville
Emma Sears,us USA,"FW,MF",24-185,16.0,18,14,10,6,2,11,19,57.9,8,15,0,15,7,25,19,0,Matches,Racing Louisville
Courtney Petersen,us USA,DF,27-303,16.0,16,15,9,6,1,8,18,44.4,10,10,4,6,16,32,64,0,Matches,Racing Louisville
Taylor Flint,us USA,MF,26-278,15.9,67,37,34,26,7,24,42,57.1,18,34,12,22,53,120,76,0,Matches,Racing Louisville
Ellie Jean,us USA,DF,28-208,14.0,7,4,5,2,0,4,7,57.1,3,12,9,3,8,15,66,0,Matches,Racing Louisville
Janine Sonis,ca CAN,"FW,DF",31-007,13.8,20,12,9,7,4,10,29,34.5,19,13,3,10,22,42,35,0,Matches,Racing Louisville
Savannah Demelo,us USA,MF,27-154,13.2,34,23,17,9,8,15,29,51.7,14,11,2,9,14,48,11,0,Matches,Racing Louisville
Lauren Milliet,us USA,DF,28-269,13.0,24,22,13,7,4,10,16,62.5,6,16,2,14,13,37,42,0,Matches,Racing Louisville
Jordyn Bloomer,us USA,GK,27-317,11.0,0,0,0,0,0,0,0,,0,0,0,0,1,1,3,0,Matches,Racing Louisville
Kayla Fischer,us USA,FW,25-234,9.6,13,10,3,7,3,6,15,40.0,9,11,0,11,4,17,3,0,Matches,Racing Louisville
Sarah Weber,us USA,"FW,MF",22-194,9.7,17,8,8,6,3,7,11,63.6,4,9,2,7,3,20,9,0,Matches,Racing Louisville
Katie O’Kane,,MF,,8.7,20,9,11,6,3,4,9,44.4,5,10,0,10,8,28,11,0,Matches,Racing Louisville
Ella Hase,us USA,"FW,DF",23-046,9.0,29,24,15,9,5,14,24,58.3,10,11,1,10,8,37,36,0,Matches,Racing Louisville
Ary Borges,br BRA,MF,25-242,6.9,32,16,13,15,4,16,28,57.1,12,8,2,6,5,37,13,0,Matches,Racing Louisville
Katie Lund,us USA,GK,28-273,6.0,0,0,0,0,0,0,0,,0,0,0,0,0,0,4,1,Matches,Racing Louisville
Marisa DiGrande,us USA,MF,28-203,5.9,14,9,8,3,3,8,14,57.1,6,5,0,5,2,16,9,0,Matches,Racing Louisville
Uchenna Kanu,ng NGA,"MF,FW",28-068,0.7,0,0,0,0,0,0,2,0.0,2,2,0,2,0,0,3,0,Matches,Racing Louisville
Elli Pikkujämsä,fi FIN,MF,25-307,0.1,0,0,0,0,0,0,0,,0,0,0,0,0,0,0,0,Matches,Racing Louisville
Bethany Balcer,us USA,"FW,MF",28-173,0.0,1,0,1,0,0,0,0,,0,2,0,2,1,2,1,0,Matches,Racing Louisville
Squad Total,,,27.6,17.0,330,215,165,115,50,150,282,53.2,132,197,51,146,183,513,510,4,,Racing Louisville
Opponent Total,,,27.0,17.0,279,180,154,90,35,140,240,58.3,100,187,53,134,140,419,387,8,,Racing Louisville
Emily Sonnett,us USA,DF,31-275,17.0,18,10,12,5,1,4,10,40.0,6,8,3,5,13,31,49,1,Matches,Gotham FC
Ann-Katrin Berger,de GER,GK,34-322,17.0,1,1,1,0,0,1,3,33.3,2,1,0,1,0,1,17,2,Matches,Gotham FC
Jaelin Howell,us USA,MF,25-279,16.0,48,28,19,20,9,17,33,51.5,16,26,4,22,20,68,26,0,Matches,Gotham FC
Lilly Reale,us USA,DF,22-015,15.6,40,28,18,13,9,22,42,52.4,20,17,3,14,28,68,47,0,Matches,Gotham FC
Esther González,es ESP,"FW,MF",32-262,15.6,12,6,1,6,5,5,8,62.5,3,2,0,2,2,14,7,0,Matches,Gotham FC
Sarah Schupansky,us USA,MF,22-002,13.1,16,7,2,9,5,3,8,37.5,5,14,1,13,4,20,6,0,Matches,Gotham FC
Jess Carter,eng ENG,DF,27-304,12.3,25,14,15,9,1,16,25,64.0,9,9,6,3,12,37,54,0,Matches,Gotham FC
Nealy Martin,us USA,"MF,DF",27-127,11.7,16,9,8,5,3,8,14,57.1,6,5,2,3,14,30,24,0,Matches,Gotham FC
Mandy Freeman,us USA,DF,30-157,10.1,7,3,1,4,2,1,4,25.0,3,7,2,5,7,14,39,1,Matches,Gotham FC
Taryn Torres,us USA,MF,26-126,8.4,15,9,3,9,3,8,15,53.3,7,11,2,9,6,21,15,1,Matches,Gotham FC
Gabi Portilho,br BRA,"MF,FW",30-040,7.5,13,9,1,8,4,6,15,40.0,9,11,0,11,7,20,4,0,Matches,Gotham FC
Geyse,br BRA,"FW,MF",27-153,7.2,16,9,5,4,7,5,13,38.5,8,11,0,11,0,16,7,0,Matches,Gotham FC
Bruninha,br BRA,"DF,MF",23-072,8.0,9,7,3,4,2,7,15,46.7,8,7,0,7,7,16,14,0,Matches,Gotham FC
Ella Stevens,us USA,MF,27-259,7.2,9,3,0,5,4,3,4,75.0,1,7,2,5,5,14,4,0,Matches,Gotham FC
Rose Lavelle,us USA,MF,30-105,3.7,5,4,0,4,1,2,5,40.0,3,1,0,1,2,7,2,0,Matches,Gotham FC
Margaret Purce,us USA,"MF,FW",29-343,4.2,15,9,4,6,5,5,12,41.7,7,11,1,10,2,17,8,0,Matches,Gotham FC
Tierna Davidson,us USA,DF,26-343,2.5,5,4,3,2,0,3,3,100.0,0,1,0,1,2,7,9,0,Matches,Gotham FC
Khyah Harper,us USA,"FW,MF",23-012,2.3,4,2,1,3,0,3,5,60.0,2,2,1,1,1,5,2,0,Matches,Gotham FC
Katie Stengel,us USA,"FW,MF",33-179,1.9,6,5,1,4,1,3,4,75.0,1,5,0,5,3,9,2,0,Matches,Gotham FC
Jéssica Silva,pt POR,"MF,DF",30-259,1.0,2,2,0,2,0,1,2,50.0,1,0,0,0,0,2,0,0,Matches,Gotham FC
Sofia Cook,us USA,"MF,FW",21-020,1.6,5,2,2,3,0,3,5,60.0,2,2,0,2,0,5,2,0,Matches,Gotham FC
Mak Whitham,us USA,"MF,FW",15-031,0.7,0,0,0,0,0,0,0,,0,0,0,0,0,0,0,0,Matches,Gotham FC
Josefine Hasbo,dk DEN,MF,23-280,0.5,1,1,1,0,0,0,1,0.0,1,0,0,0,0,1,1,0,Matches,Gotham FC
Cecelia Kizer,us USA,MF,28-050,0.4,0,0,0,0,0,0,0,,0,2,0,2,0,0,0,0,Matches,Gotham FC
Stella Nyamekye,gh GHA,MF,19-343,0.3,1,0,1,0,0,0,1,0.0,1,1,0,1,0,1,0,0,Matches,Gotham FC
Kayla Duran,,DF,,0.2,1,0,1,0,0,0,0,,0,0,0,0,1,2,4,0,Matches,Gotham FC
Ryan Campbell,us USA,GK,23-162,0.0,0,0,0,0,0,0,0,,0,0,0,0,0,0,0,0,Matches,Gotham FC
Squad Total,,,28.1,17.0,290,172,103,125,62,126,247,51.0,121,161,27,134,136,426,343,5,,Gotham FC
Opponent Total,,,27.4,17.0,341,240,182,120,39,145,290,50.0,145,206,47,159,188,529,496,7,,Gotham FC
Kaleigh Kurtz,us USA,DF,27-352,17.0,22,17,15,7,0,7,13,53.8,6,23,14,9,20,42,103,4,Matches,North Carolina Courage
Casey Murphy,us USA,GK,29-124,17.0,0,0,0,0,0,0,0,,0,0,0,0,0,0,9,2,Matches,North Carolina Courage
Ryan Williams,us USA,"DF,MF",29-185,17.0,27,18,11,10,6,9,21,42.9,12,25,11,14,22,49,60,0,Matches,North Carolina Courage
Denise O'Sullivan,ie IRL,MF,31-204,15.5,72,51,34,27,11,32,58,55.2,26,37,2,35,27,99,18,0,Matches,North Carolina Courage
Manaka Matsukubo,jp JPN,"FW,MF",21-030,14.6,17,11,9,7,1,7,19,36.8,12,12,0,12,7,24,9,0,Matches,North Carolina Courage
Riley Jackson,us USA,MF,19-268,13.8,35,20,21,13,1,16,27,59.3,11,14,4,10,8,43,16,1,Matches,North Carolina Courage
Maycee Bell,us USA,DF,24-343,14.2,27,20,23,3,1,16,24,66.7,8,17,9,8,7,34,58,0,Matches,North Carolina Courage
Ashley Sanchez,us USA,"FW,MF",26-164,11.8,17,11,2,9,6,5,11,45.5,6,20,1,19,8,25,15,0,Matches,North Carolina Courage
Jaedyn Shaw,us USA,"FW,MF",20-280,9.6,25,14,10,10,5,8,11,72.7,3,8,1,7,3,28,4,0,Matches,North Carolina Courage
Shinomi Koyama,jp JPN,"MF,FW",20-208,8.1,18,12,9,5,4,7,8,87.5,1,9,1,8,2,20,4,0,Matches,North Carolina Courage
Malia Berkely,us USA,DF,27-195,7.6,10,5,5,4,1,6,10,60.0,4,11,5,6,9,19,17,2,Matches,North Carolina Courage
Felicitas Rauch,de GER,"DF,MF",29-119,7.5,10,8,5,2,3,9,12,75.0,3,10,2,8,8,18,25,0,Matches,North Carolina Courage
Tyler Lussi,us USA,"FW,MF",30-213,7.4,22,15,8,7,7,9,13,69.2,4,8,1,7,7,29,15,0,Matches,North Carolina Courage
Talia Staude,us USA,DF,24-129,6.8,15,9,9,4,2,11,14,78.6,3,8,6,2,6,21,23,0,Matches,North Carolina Courage
Hannah Betfort,us USA,FW,26-235,5.3,4,3,1,2,1,3,6,50.0,3,10,3,7,1,5,7,0,Matches,North Carolina Courage
Brianna Pinto,us USA,"FW,MF",25-095,3.9,3,0,2,1,0,2,4,50.0,2,3,0,3,4,7,1,0,Matches,North Carolina Courage
Cortnee Vine,au AUS,FW,27-140,3.5,4,1,0,3,1,3,4,75.0,1,3,0,3,3,7,3,0,Matches,North Carolina Courage
Aline,br BRA,"FW,MF",20-051,2.9,4,2,1,3,0,0,1,0.0,1,6,0,6,1,5,1,0,Matches,North Carolina Courage
Meredith Speck,us USA,"FW,DF",32-207,2.7,4,4,2,2,0,2,6,33.3,4,2,0,2,2,6,2,0,Matches,North Carolina Courage
Dani Weatherholt,us USA,"MF,DF",31-163,0.5,1,0,1,0,0,0,0,,0,0,0,0,1,2,5,0,Matches,North Carolina Courage
Brooklyn Courtnall,ca CAN,"DF,FW",22-242,0.3,4,2,2,0,2,3,6,50.0,3,0,0,0,1,5,1,0,Matches,North Carolina Courage
Squad Total,,,26.2,17.0,341,223,170,119,52,155,268,57.8,113,226,60,166,147,488,396,9,,North Carolina Courage
Opponent Total,,,27.3,17.0,275,196,105,106,64,119,223,53.4,104,194,54,140,178,453,425,4,,North Carolina Courage
Sarah Gorden,us USA,DF,32-348,16.3,16,12,13,2,1,9,15,60.0,6,12,9,3,15,31,67,1,Matches,Angel City FC
Riley Tiernan,us USA,FW,22-286,16.2,14,10,2,5,7,1,9,11.1,8,19,3,16,7,21,7,0,Matches,Angel City FC
Alyssa Thompson,us USA,"FW,MF",20-293,15.5,35,22,9,18,8,16,24,66.7,8,14,2,12,8,43,13,0,Matches,Angel City FC
Alanna Kennedy,au AUS,"MF,DF",30-218,15.0,19,13,10,8,1,10,21,47.6,11,16,6,10,11,30,66,1,Matches,Angel City FC
Kennedy Fuller,us USA,MF,18-171,14.5,22,15,5,15,2,6,19,31.6,13,28,4,24,8,30,21,0,Matches,Angel City FC
Angelina Anderson,us USA,GK,24-158,15.0,0,0,0,0,0,0,0,,0,0,0,0,0,0,15,2,Matches,Angel City FC
Mary Vignola,us USA,DF,27-197,12.5,38,20,30,5,3,19,27,70.4,8,29,7,22,18,56,43,0,Matches,Angel City FC
Gisele Thompson,us USA,"DF,FW",19-268,11.1,30,15,10,12,8,15,16,93.8,1,14,2,12,15,45,20,0,Matches,Angel City FC
Savannah King,us USA,DF,20-201,7.9,6,4,2,3,1,1,4,25.0,3,8,4,4,10,16,36,1,Matches,Angel City FC
Miyabi Moriya,jp JPN,DF,29-005,8.9,29,18,16,8,5,11,18,61.1,7,14,4,10,11,40,26,0,Matches,Angel City FC
Macey Hodge,us USA,MF,24-115,6.7,25,14,7,14,4,7,14,50.0,7,9,2,7,7,32,14,1,Matches,Angel City FC
Claire Emslie,sct SCO,"FW,MF",31-172,5.8,10,7,2,3,5,4,12,33.3,8,5,0,5,3,13,4,0,Matches,Angel City FC
Madison Hammond,us USA,MF,27-285,7.5,19,15,6,12,1,7,15,46.7,8,11,2,9,7,26,13,1,Matches,Angel City FC
Megan Reid,us USA,DF,29-140,7.0,11,10,5,6,0,5,9,55.6,4,10,8,2,2,13,53,0,Matches,Angel City FC
Katie Zelem,eng ENG,MF,29-219,6.5,14,10,6,5,3,3,8,37.5,5,7,0,7,11,25,8,1,Matches,Angel City FC
Julie Dufour,fr FRA,"FW,MF",24-090,4.1,5,4,3,1,1,0,2,0.0,2,5,0,5,3,8,0,0,Matches,Angel City FC
Sveindís Jane Jónsdóttir,is ISL,FW,24-083,3.8,7,6,4,1,2,4,7,57.1,3,9,0,9,4,11,9,0,Matches,Angel City FC
Evelyn Shores,us USA,DF,20-241,3.3,11,9,5,6,0,3,8,37.5,5,2,0,2,9,20,16,0,Matches,Angel City FC
Christen Press,us USA,"FW,MF",36-241,3.8,6,5,2,4,0,4,7,57.1,3,3,0,3,6,12,2,0,Matches,Angel City FC
Hannah Seabert,dk DEN,GK,30-180,2.0,0,0,0,0,0,0,0,,0,0,0,0,0,0,2,0,Matches,Angel City FC
Jun Endō,jp JPN,MF,25-095,1.5,1,1,0,0,1,0,3,0.0,3,1,0,1,1,2,1,0,Matches,Angel City FC
Casey Phair,kr KOR,"FW,MF",18-059,1.0,0,0,0,0,0,0,0,,0,2,0,2,0,0,0,0,Matches,Angel City FC
Maiara,br BRA,MF,21-016,0.6,3,3,0,2,1,1,3,33.3,2,1,0,1,1,4,0,0,Matches,Angel City FC
Hannah Johnson,us USA,DF,22-188,0.3,1,1,0,0,1,1,1,100.0,0,0,0,0,0,1,0,1,Matches,Angel City FC
Sophia Mattice,us USA,"DF,MF",23-063,0.3,0,0,0,0,0,0,1,0.0,1,1,0,1,0,0,3,0,Matches,Angel City FC
Squad Total,,,25.7,17.0,322,214,137,130,55,127,243,52.3,116,220,53,167,157,479,439,9,,Angel City FC
Opponent Total,,,27.3,17.0,289,180,128,113,48,114,234,48.7,120,192,59,133,147,436,439,8,,Angel City FC
Danielle Colaprico,us USA,MF,32-113,15.5,30,18,14,13,3,13,22,59.1,9,16,5,11,26,56,30,0,Matches,Houston Dash
Delanie Sheehan,us USA,MF,26-226,14.7,25,16,9,13,3,9,19,47.4,10,24,1,23,11,36,19,1,Matches,Houston Dash
Paige Nielsen,us USA,DF,31-317,15.6,23,16,15,7,1,16,22,72.7,6,11,6,5,17,40,104,2,Matches,Houston Dash
Yazmeen Ryan,us USA,"FW,MF",26-183,15.0,16,10,3,7,6,3,8,37.5,5,15,2,13,8,24,12,2,Matches,Houston Dash
Maggie Graham,us USA,"MF,DF",23-048,14.0,23,13,10,9,4,10,21,47.6,11,20,7,13,14,37,20,0,Matches,Houston Dash
Natalie Jacobs,us USA,DF,28-011,13.1,20,13,13,6,1,8,12,66.7,4,17,11,6,27,47,62,1,Matches,Houston Dash
Avery Patterson,us USA,"DF,MF",23-074,12.5,35,20,22,10,3,19,25,76.0,6,19,3,16,20,55,37,0,Matches,Houston Dash
Katie Lind,us USA,DF,31-193,12.0,13,8,9,4,0,4,6,66.7,2,16,12,4,9,22,56,0,Matches,Houston Dash
Jane Campbell,us USA,GK,30-191,12.0,0,0,0,0,0,0,0,,0,0,0,0,0,0,5,1,Matches,Houston Dash
Ryan Gareis,us USA,"MF,DF",26-287,10.2,6,5,1,4,1,2,5,40.0,3,11,2,9,4,10,11,0,Matches,Houston Dash
Bárbara Olivieri,ve VEN,"FW,MF",23-184,9.9,24,15,9,9,6,12,26,46.2,14,17,0,17,18,42,8,0,Matches,Houston Dash
Messiah Bright,us USA,FW,25-227,8.7,13,7,2,7,4,6,7,85.7,1,7,1,6,4,17,2,0,Matches,Houston Dash
Christen Westphal,us USA,DF,31-359,5.9,13,11,7,2,4,9,12,75.0,3,11,5,6,8,21,26,0,Matches,Houston Dash
Kiki Van Zanten,jm JAM,"FW,MF",24-002,5.2,22,17,9,4,9,12,20,60.0,8,11,0,11,7,29,9,0,Matches,Houston Dash
Abby Smith,us USA,GK,31-327,5.0,0,0,0,0,0,0,0,,0,0,0,0,0,0,3,1,Matches,Houston Dash
Evelina Duljan,se SWE,"FW,MF",22-107,4.5,11,6,3,7,1,7,16,43.8,9,9,1,8,4,15,2,0,Matches,Houston Dash
Allysha Chapman,ca CAN,DF,36-214,3.8,5,2,5,0,0,3,4,75.0,1,7,3,4,10,15,10,0,Matches,Houston Dash
Sophie Schmidt,ca CAN,MF,37-060,2.3,7,6,3,2,2,2,3,66.7,1,3,1,2,5,12,5,0,Matches,Houston Dash
Michelle Alozie,ng NGA,"DF,MF",28-121,3.6,5,3,2,2,1,2,8,25.0,6,3,1,2,2,7,11,0,Matches,Houston Dash
Sarah Puntigam,at AUT,MF,32-318,2.0,5,3,2,2,1,2,3,66.7,1,6,0,6,0,5,1,0,Matches,Houston Dash
Diana Ordoñez,mx MEX,FW,23-335,0.8,0,0,0,0,0,0,0,,0,2,0,2,1,1,0,0,Matches,Houston Dash
Ramona Bachmann,ch SUI,MF,34-245,0.4,1,1,1,0,0,0,0,,0,0,0,0,0,1,0,0,Matches,Houston Dash
Clarissa Larisey,ca CAN,MF,26-056,0.1,0,0,0,0,0,0,0,,0,0,0,0,0,0,0,0,Matches,Houston Dash
Squad Total,,,28.1,17.0,297,190,139,108,50,139,239,58.2,100,225,61,164,195,492,433,8,,Houston Dash
Opponent Total,,,27.2,17.0,346,222,164,134,48,170,278,61.2,108,199,35,164,160,506,395,7,,Houston Dash
Caprice Dydasco,us USA,DF,32-008,17.0,34,21,14,13,7,18,28,64.3,10,20,9,11,29,63,46,0,Matches,Bay FC
Taylor Huff,us USA,"MF,FW",23-011,16.0,27,17,14,9,4,10,20,50.0,10,8,3,5,12,39,26,0,Matches,Bay FC
Racheal Kundananji,zm ZAM,"FW,MF",25-085,15.0,26,18,4,14,8,7,18,38.9,11,22,1,21,9,35,6,0,Matches,Bay FC
Jordan Silkowitz,us USA,GK,25-153,15.0,0,0,0,0,0,0,2,0.0,2,0,0,0,0,0,9,2,Matches,Bay FC
Alyssa Malonson,us USA,DF,26-140,14.8,40,22,30,8,2,16,22,72.7,6,13,3,10,30,70,64,2,Matches,Bay FC
Abby Dahlkemper,us USA,DF,32-106,13.0,11,7,3,8,0,7,11,63.6,4,7,4,3,3,14,58,1,Matches,Bay FC
Caroline Conti,us USA,"MF,FW",24-152,11.8,20,16,3,12,5,9,18,50.0,9,12,1,11,6,26,13,0,Matches,Bay FC
Joelle Anderson,us USA,DF,26-325,11.1,16,11,10,5,1,6,10,60.0,4,10,5,5,11,27,69,1,Matches,Bay FC
Kiki Pickett,us USA,MF,26-119,10.4,15,10,5,6,4,7,10,70.0,3,12,3,9,14,29,26,0,Matches,Bay FC
Dorian Bailey,us USA,MF,28-211,8.3,12,9,3,7,2,5,9,55.6,4,11,2,9,15,27,17,0,Matches,Bay FC
Rachel Hill,us USA,"MF,FW",30-132,8.2,20,14,4,13,3,11,22,50.0,11,8,0,8,6,26,13,0,Matches,Bay FC
Penelope Hocking,us USA,"MF,FW",25-241,8.0,15,11,9,4,2,6,10,60.0,4,11,1,10,3,18,6,1,Matches,Bay FC
Karlie Lema,us USA,"FW,MF",22-059,8.0,19,11,12,5,2,5,9,55.6,4,10,0,10,3,22,8,0,Matches,Bay FC
Hannah Bebar,us USA,MF,23-356,5.9,17,13,5,7,5,12,26,46.2,14,14,1,13,10,27,15,0,Matches,Bay FC
Kelli Hubly,us USA,DF,31-018,6.3,15,6,12,2,1,11,11,100.0,0,8,3,5,6,21,45,0,Matches,Bay FC
Asisat Oshoala,ng NGA,FW,30-322,5.1,6,4,3,2,1,0,2,0.0,2,6,0,6,2,8,5,0,Matches,Bay FC
Tess Boade,us USA,"MF,FW",26-205,4.3,6,5,1,4,1,4,10,40.0,6,4,0,4,4,10,2,0,Matches,Bay FC
Emily Menges,us USA,DF,33-030,2.9,2,1,1,1,0,2,6,33.3,4,4,3,1,2,4,14,0,Matches,Bay FC
Emmie Allen,us USA,GK,22-306,2.0,0,0,0,0,0,0,0,,0,0,0,0,0,0,0,0,Matches,Bay FC
Madeline Moreau,us USA,"DF,MF",24-265,1.8,3,2,0,2,1,2,4,50.0,2,5,0,5,2,5,9,0,Matches,Bay FC
Jamie Shepherd,us USA,MF,24-322,1.7,2,2,0,2,0,0,1,0.0,1,3,1,2,1,3,4,0,Matches,Bay FC
Jordan Brewster,us USA,DF,25-334,0.3,0,0,0,0,0,0,0,,0,1,1,0,1,1,2,0,Matches,Bay FC
Catherine Paulson,us USA,DF,23-295,0.1,0,0,0,0,0,0,0,,0,0,0,0,0,0,1,0,Matches,Bay FC
Squad Total,,,27.1,17.0,306,200,133,124,49,138,249,55.4,111,189,41,148,169,475,458,7,,Bay FC
Opponent Total,,,27.4,17.0,286,181,131,114,41,144,254,56.7,110,181,39,142,157,443,461,7,,Bay FC
Taylor Malham,us USA,DF,26-099,17.0,43,31,24,13,6,22,24,91.7,2,16,3,13,19,62,64,0,Matches,Chicago Red Stars
Samantha Staab,us USA,DF,28-152,15.0,13,10,5,8,0,6,11,54.5,5,19,11,8,10,23,88,0,Matches,Chicago Red Stars
Julia Grosso,ca CAN,"MF,FW",24-363,14.5,29,19,8,14,7,12,21,57.1,9,14,0,14,8,37,10,0,Matches,Chicago Red Stars
Ally Schlegel,us USA,"FW,MF",25-201,13.5,19,13,6,9,4,5,19,26.3,14,17,3,14,7,26,21,0,Matches,Chicago Red Stars
Alyssa Naeher,us USA,GK,37-129,14.0,0,0,0,0,0,0,0,,0,0,0,0,0,0,6,2,Matches,Chicago Red Stars
Cari Roccaro,us USA,"DF,MF",31-040,13.4,18,9,12,5,1,8,10,80.0,2,10,4,6,17,35,56,0,Matches,Chicago Red Stars
Maitane López Millán,es ESP,MF,30-167,13.4,36,22,15,18,3,12,21,57.1,9,17,6,11,19,55,25,0,Matches,Chicago Red Stars
Ludmila,br BRA,FW,30-269,12.8,20,12,6,12,2,4,13,30.8,9,12,0,12,8,28,4,0,Matches,Chicago Red Stars
Bea Franklin,us USA,"MF,DF",24-327,12.1,21,8,15,3,3,3,10,30.0,7,19,9,10,22,43,35,2,Matches,Chicago Red Stars
Camryn Biegalski,us USA,DF,27-016,11.1,43,33,34,6,3,26,37,70.3,11,17,6,11,14,57,46,3,Matches,Chicago Red Stars
Jameese Joseph,us USA,"MF,FW",23-116,8.9,20,10,11,5,4,8,15,53.3,7,8,1,7,4,24,4,0,Matches,Chicago Red Stars
Shea Groom,us USA,"FW,MF",32-176,8.8,15,6,6,7,2,8,13,61.5,5,12,3,9,5,20,11,0,Matches,Chicago Red Stars
Jenna Bike,us USA,"FW,MF",27-206,4.6,6,3,0,3,3,2,4,50.0,2,3,0,3,2,8,7,0,Matches,Chicago Red Stars
Natalia Kuikka,fi FIN,DF,29-269,3.9,10,6,5,4,1,5,9,55.6,4,8,1,7,3,13,16,0,Matches,Chicago Red Stars
Manaka Hayashi,jp JPN,MF,21-011,4.8,18,12,2,13,3,9,15,60.0,6,7,0,7,3,21,6,1,Matches,Chicago Red Stars
Hannah Anderson,us USA,DF,24-146,4.1,6,3,5,1,0,4,6,66.7,2,8,3,5,6,12,22,1,Matches,Chicago Red Stars
Kathrin Hendrich,de GER,DF,33-143,3.2,2,2,1,1,0,1,3,33.3,2,3,3,0,2,4,13,1,Matches,Chicago Red Stars
Halle Mackiewicz,us USA,GK,23-337,3.0,0,0,0,0,0,0,0,,0,0,0,0,0,0,0,0,Matches,Chicago Red Stars
Nádia Gomes,pt POR,"FW,MF",28-291,3.2,8,3,4,2,2,2,6,33.3,4,7,1,6,4,12,10,0,Matches,Chicago Red Stars
Leilanni Nesbeth,bm BER,"FW,MF",24-041,1.2,6,4,1,4,1,3,5,60.0,2,2,0,2,0,6,2,0,Matches,Chicago Red Stars
Justina Gaynor,us USA,DF,23-249,0.8,1,1,0,0,1,1,1,100.0,0,1,0,1,3,4,1,1,Matches,Chicago Red Stars
Micayla Johnson,us USA,"FW,MF",17-221,1.7,3,3,1,1,1,2,4,50.0,2,3,1,2,3,6,0,1,Matches,Chicago Red Stars
Chardonnay Curran,us USA,"MF,FW",26-009,0.9,1,1,0,1,0,1,3,33.3,2,1,0,1,2,3,1,0,Matches,Chicago Red Stars
Ava Cook,us USA,"FW,DF",25-053,0.7,1,1,0,0,1,0,1,0.0,1,1,0,1,2,3,3,0,Matches,Chicago Red Stars
Catherine Barry,us USA,FW,23-254,0.5,1,1,0,1,0,0,0,,0,0,0,0,1,2,2,0,Matches,Chicago Red Stars
Squad Total,,,28.1,17.0,340,213,161,131,48,144,251,57.4,107,205,55,150,164,504,453,12,,Chicago Red Stars
Opponent Total,,,26.9,17.0,302,201,116,129,57,129,225,57.3,96,186,38,148,117,419,360,7,,Chicago Red Stars
Kate Del Fava,us USA,DF,27-035,17.0,18,15,12,5,1,12,19,63.2,7,13,11,2,23,41,108,1,Matches,Utah Royals FC
Amanda McGlynn,us USA,GK,26-297,16.0,2,1,2,0,0,2,3,66.7,1,0,0,0,0,2,12,4,Matches,Utah Royals FC
Claudia Zornoza,es ESP,MF,34-311,13.4,31,18,8,19,4,18,46,39.1,28,11,2,9,9,40,16,0,Matches,Utah Royals FC
Mina Tanaka,jp JPN,"MF,FW",31-121,13.1,20,15,8,8,4,12,12,100.0,0,14,1,13,8,28,17,0,Matches,Utah Royals FC
Ally Sentnor,us USA,"FW,MF",21-190,12.5,15,9,7,5,3,10,18,55.6,8,21,1,20,2,17,6,0,Matches,Utah Royals FC
Nuria Rábano,es ESP,DF,26-073,10.8,57,42,41,11,5,36,52,69.2,16,17,4,13,20,77,56,0,Matches,Utah Royals FC
Ana Tejada,es ESP,"DF,MF",23-086,11.7,22,11,10,12,0,14,23,60.9,9,10,3,7,8,30,42,1,Matches,Utah Royals FC
Brecken Mozingo,us USA,"FW,MF",24-172,11.0,19,16,7,6,6,6,15,40.0,9,7,0,7,4,23,14,0,Matches,Utah Royals FC
Janni Thomsen,dk DEN,"DF,FW",25-192,12.1,25,18,15,8,2,18,29,62.1,11,17,5,12,15,40,38,2,Matches,Utah Royals FC
Bianca St-Georges,ca CAN,FW,28-030,9.4,21,14,12,6,3,9,13,69.2,4,9,2,7,6,27,8,0,Matches,Utah Royals FC
Dana Foederer,nl NED,MF,23-031,10.1,24,14,17,5,2,21,37,56.8,16,19,2,17,6,30,15,1,Matches,Utah Royals FC
Aisha Solórzano,gt GUA,FW,27-136,6.9,5,4,1,2,2,3,6,50.0,3,5,1,4,1,6,0,0,Matches,Utah Royals FC
Lauren Flynn,us USA,DF,23-097,6.8,12,8,8,4,0,7,11,63.6,4,9,4,5,7,19,51,0,Matches,Utah Royals FC
Imani Dorsey,us USA,DF,29-159,5.3,13,10,9,3,1,4,5,80.0,1,5,2,3,2,15,17,0,Matches,Utah Royals FC
Cecelia Kizer,us USA,"FW,MF",28-050,4.3,7,5,3,1,3,3,7,42.9,4,4,0,4,3,10,5,1,Matches,Utah Royals FC
Paige Monaghan,us USA,"FW,DF",28-287,3.8,7,4,6,0,1,4,7,57.1,3,7,0,7,2,9,10,0,Matches,Utah Royals FC
Madison Pogarch,us USA,DF,27-295,6.6,16,10,9,6,1,7,15,46.7,8,6,2,4,5,21,10,0,Matches,Utah Royals FC
Kaleigh Riehl,us USA,DF,28-310,4.1,2,2,2,0,0,1,2,50.0,1,11,7,4,4,6,19,0,Matches,Utah Royals FC
Aria Nagai,,MF,,3.0,5,3,2,3,0,3,4,75.0,1,4,0,4,9,14,7,0,Matches,Utah Royals FC
Macey Fraser,nz NZL,FW,23-047,2.1,6,6,3,3,0,4,7,57.1,3,2,0,2,0,6,0,0,Matches,Utah Royals FC
KK Ream,us USA,"FW,MF",16-051,1.9,2,2,1,1,0,1,1,100.0,0,0,0,0,3,5,0,0,Matches,Utah Royals FC
Mikayla Cluff,us USA,MF,26-183,1.7,3,2,2,1,0,0,4,0.0,4,4,0,4,2,5,1,0,Matches,Utah Royals FC
Mia Justus,us USA,GK,22-358,1.0,0,0,0,0,0,0,0,,0,0,0,0,0,0,0,1,Matches,Utah Royals FC
Cloé Lacasse,ca CAN,FW,32-051,1.0,1,1,0,0,1,0,0,,0,0,0,0,1,2,0,0,Matches,Utah Royals FC
Ana María Guzmán,co COL,"DF,FW",20-077,0.9,2,2,0,1,1,2,3,66.7,1,2,0,2,1,3,2,0,Matches,Utah Royals FC
Sydney Jones,,FW,,0.1,0,0,0,0,0,0,1,0.0,1,0,0,0,0,0,0,0,Matches,Utah Royals FC
Alex Loera,us USA,MF,26-069,0.1,0,0,0,0,0,0,0,,0,0,0,0,0,0,0,0,Matches,Utah Royals FC
Squad Total,,,26.7,17.0,335,232,185,110,40,197,340,57.9,143,197,47,150,141,476,454,11,,Utah Royals FC
Opponent Total,,,27.3,17.0,277,185,101,122,54,112,205,54.6,93,186,51,135,166,443,299,1,,Utah Royals FC
